S O X X X 
O O X C X 
O P O O O 
O X O A O 
O O O O E 
