E A O X X 
O O O O X 
P O O O X 
O O O O X 
X X X O S 
