S O O O X 
X O X O O 
O O O O E 
P O X A O 
X O X X O 
