X O O O E 
O O X X X 
O O O O S 
X A O O O 
X X X O P 
